abrunden.exe	Budenberg Modul abrunden
aehnlich.exe	Budenberg Modul aehnlich
anlaut.exe	Budenberg Modul anlaut
begriff.exe	Budenberg Modul begriff
bildles.exe	Budenberg Modul bildles
bildschr.exe	Budenberg Modul bildschr
bildwort.exe	Budenberg Modul bildwort
brd.exe	Budenberg Modul brd
bruchre.exe	Budenberg Modul bruchre
buchstab.exe	Budenberg Modul buchstab
buchstw.exe	Budenberg Modul buchstw
deldatum.exe	Budenberg Modul deldatum
dezimal.exe	Budenberg Modul dezimal
doppelt.exe	Budenberg Modul doppelt
einmal.exe	Budenberg Modul einmal
erstles.exe	Budenberg Modul erstles
euro.exe	Budenberg Modul euro
form.exe	Budenberg Modul form
geld.exe	Budenberg Modul geld
geldc.exe	Budenberg Modul geldc
geomet1.exe	Budenberg Modul geomet1
geomet2.exe	Budenberg Modul geomet2
geomet3.exe	Budenberg Modul geomet3
gleich.exe	Budenberg Modul gleich
grzahlen.exe	Budenberg Modul grzahlen
hundert.exe	Budenberg Modul hundert
info.exe	Budenberg Modul info
kegel.exe	Budenberg Modul kegel
kran.exe	Budenberg Modul kran
kreuzw.exe	Budenberg Modul kreuzw
lesetr.exe	Budenberg Modul lesetr
minitext.exe	Budenberg Modul minitext
partner.exe	Budenberg Modul partner
raetsel.exe	Budenberg Modul raetsel
rechmix.exe	Budenberg Modul rechmix
richtung.exe	Budenberg Modul richtung
rschreib.exe	Budenberg Modul rschreib
satzbau.exe	Budenberg Modul satzbau
silbenw.exe	Budenberg Modul silbenw
silbles.exe	Budenberg Modul silbles
srechnen.exe	Budenberg Modul srechnen
teilen.exe	Budenberg Modul teilen
textgli.exe	Budenberg Modul textgli
textschr.exe	Budenberg Modul textschr
trainer.exe	Budenberg Modul trainer
tutor.exe	Budenberg Modul tutor
uhr.exe	Budenberg Modul uhr
verglei.exe	Budenberg Modul verglei
verkehr.exe	Budenberg Modul verkehr
wdiktat.exe	Budenberg Modul wdiktat
weiter.exe	Budenberg Modul weiter
wortart.exe	Budenberg Modul wortart
wortra.exe	Budenberg Modul wortra
wsuchen.exe	Budenberg Modul wsuchen
wuerfel.exe	Budenberg Modul wuerfel
zahlbild.exe	Budenberg Modul zahlbild
zahlenra.exe	Budenberg Modul zahlenra
zbuendel.exe	Budenberg Modul zbuendel
zehnein.exe	Budenberg Modul zehnein
zehnueb.exe	Budenberg Modul zehnueb
zerlegen.exe	Budenberg Modul zerlegen
zhaus.exe	Budenberg Modul zhaus
zraum20.exe	Budenberg Modul zraum20
zreihe.exe	Budenberg Modul zreihe
zstrahl.exe	Budenberg Modul zstrahl
zweitles.exe	Budenberg Modul zweitles
bb.exe	Budenberg Grundprogramm